22 21
"                      "
"0000000000000000      "
"  s  s         0      " 
"               0      "
"  s            0      "
"               0      "
"   s      000000      " 
"          0           "
"      00000           "
"    s 0               "
"      00000000000     "
"                0     "
"          s     0     "
"    s           0s    "
"000000000000    0 s   " 
"           0  s 00000 "
"           0        0 " 
"           0000000000 "
"                      "
"                      "
"                      "
