11 13
++++++s++++++
0000000000+++
++s+++s++0+s+
+++++00000+++
+s+++0+++s+++
+000s0000000+
+0+0++s++++0+
+0+0+++++s+0+
+0+000000000+
00+++s+++++++
++++++++s++++
